
#######################
#######################


#######################

 ##
##

                                           #######################
#######################


                     #
			#
			#
			#
			#
			#
			#########
		####